10101010101010101010101010101010101010101010101010
01010101010101010101010101010101010101010101010101
10101010101010101010101010101010101010101010101010
22222222222222222222222222222222222222222222222222
10101010101010101010101010101010101010101010101010
01010101010101010101010101010101010101010101010101
10101010101010101010101010101010101010101010101010
01010101010101010101010101010101010101010101010101
10101010101010101010101010101010101010101010101010
01010101010101010101010101010101010101010101010101
10101010101010101010101010101010101010101010101010
01010101010101010101010101010101010101010101010101
10101010101010101010101010101010101010101010101010
01010101010101010101010101010101010101010101010101
10101010101010101010101010101010101010101010101010
01010101010101010101010101010101010101010101010101
10101010101010101010101010101010101010101010101010
01010101010101010101010101010101010101010101010101
10101010101010101010101010101010101010101010101010
01010101010101010101010101010101010101010101010101
10101010101010101010101010101010101010101010101010
01010101010101010101010101010101010101010101010101
10101010101010101010101010101010101010101010101010
01010101010101010101010101010101010101010101010101
10101010101010101010101010101010101010101010101010
01010101010101010101010101010101010101010101010101
10101010101010101010101010101010101010101010101010
01010101010101010101010101010101010101010101010101
10101010101010101010101010101010101010101010101010
01010101010101010101010101010101010101010101010101